ahpC	CCTTACATCTCATCGAAAACACGGAGGAAGTATAG
pgk	CTGCAAAACTTTTAGAATCAACGAGAGGATTCACC
deoC	GGTGAATTTTATTGGCGACAAGCCAGGAGAATGAA
deoD	CTCCGCCTTTGTTATGTCACAAAAAGGATAAAACA
tig	GTTGACCGAGCACTGTGATTTTTTGAGGTAACAAG
csrA	CAGACCCGACTCTTTTAATCTTTCAAGGAGCAAAGA
ompA	CATGGCGTATTTTGGATGATAACGAGGCGCAAAAA
tpx	GTGACGTTAACTATATGTAAACAGGAAAGATAATC
yifE	TAACTAGCTCGGTCAAAGAATTAGGAGCGTGCAGG
dapD	GGTGATGTGTTTACTGATATGAAAAGAGTTTAACA
fabI	AGGCACAACAAGCATCAACAATAAGGATTAAAGCT
pflB	TAAATAAAAAATCCACTTAAGAAGGTAGGTGTTAC
ackA	GTTTTTTTAGCCACGTATCAATTATAGGTACTTCC
glyA	AAAAATTTTATTGTTAGCTGAGTCAGGAGATGCGG
fabD	CCGCGCTGGTTCGTTTCTAGGATAAGGATTAAAAC
grcA	GAACAAATCAAATAATTTTGCCGGGGAGGCATCAC
talB	TCCCCCTAACAAGCTGTTTAAAGAGAAATACTATC
cspE	CATTTGTGTCTATTTTTCATGTAAAGGTAATTTTG
yncE	CGCAGCAAAAATATCGGTTCATCAAAGGGAGTCGTC
yebC	TGCCTGAACAGGCAGGGCTATCTGGAGATATTTTT
cspA	CGAAAGGCACACTTAATTATTAAAGGTAATACACT
glnA	CACGACGACCATGACCAATCCAGGAGAGTTAAAGT
ybaB	GTTCGTCATCCTTAACGTGATTGAGAGAGAAACCT
cspC	TGCGGGCGAAGAAAACAATCTAAGGAATTTTTCAA
hfq	TCAAAGTACAAATAAGCATATAAGGAAAAGAGAGA
pnp	TAAGGTACTGTCTAAGAAAGAGAAAGGATATTACA
adhE	TTACTAAAAAAGTTTAACATTATCAGGAGAGCATT
pal	ATAATAATTAATTGAATAGTAAAGGAATCATTGAA
serA	CCGCACACAACATTTCAAAAGACAGGATTGGGTAA
ppiB	GTTGAAGCACCAATCAAACGGAACAGGATGCAAAA
slyB	TGCGTGGCGTTTCATGGTGAACAGGAGATTTTTCA
atpE	TACTACGTTTTAACTGAAACAAACTGGAGACTGTC
rpoC	CAGCGGATTGTGCTAACTCCGACGGGAGCAAATCC
dps	ATTACTGGGACATAACATCAAGAGGATATGAAATT
araA	TGCCCAGGCCGTTGCGACTCTATAAGGACACGATA
ompC	AAGCAAATAAAGGCATATAACAGAGGGTTAATAAC
apt	CCGTGAGTACCACCGTAACAAGCAGGCATACACTT
speB	TTTTTTTATATCGACTTTGTAATAGGAGTCCATCC
mdh	ATATCTTAGTTTATCAATATAATAAGGAGTTTAGG
fabZ	ATTGTCGTTTCTTATATTTTGACAGGAAGAGTATC
dksA	ATGGGGATCGATAGTGCGTGTTAAGGAGAAGCAAC
yajQ	TATGCTTCGCATCAAAAATGAAGGGAGAGGAAAAG
ydfZ	GGCTTCGACTGTAAATCAGAAAGGAGAAAACACCT
bcp	TATTCCCAACATGATGAACAGGATGGAGTTAAGTA
dsbA	ATTAACACCTATGTATTAATCGGAGAGAGTAGATC
yeeX	ACGAATCCGACTCTCACATTATCAGGGGTATAAAA
arcA	CTGTTTCGATTTAGTTGGCAATTTAGGTAGCAAAC
ompT	ATTCAATCATTAAAACGATTGAATGGAGAACTTTT
potD	CGTGATAAAACGAAAGGTAACACAGGGGACGTTAA
greA	CTTGCCCTATCAGGAATATTCAAGAGGTATAACAA
pepD	TACTGTTTTGCGGGTGATCGACAAGGAGACTTAAC
rpiA	TGCGTGTGAAATTTCATACCACAGGCGAAACGATC
cspD	CTTACTTGTATAAGATTTGCGAAGGATGTCGAAGC
yjgA	TGGTAACATTAGCCTCTTTTTTTAAGGAGCCTGAG
atpA	TTGCAGACGTCTTGCAGTCTTAAGGGGACTGGAGC
yeaD	TTTTACCTGATAAAATGAAGTTAAAGGACTGCGTC
yajC	GAACGTTGATTAATATTAATAATGAGGGAAATTTA
uspA	CCAGTCATCGACAACTTTATGGAAGGAGTAACACT
thiC	TGACAAGCCACGTCCTTAACTTTTTGGAATGAGCT
cspG	GTTTGCCGAAAGGCCCAAAATGAAGGAAGTAAAAT
ihfA	CAGAGCGATTCCAGGCATCATTGAGGGATTGAACCT
rpoD	CACCAACCTCATGAAATAAGTGTGGATACCGTCTT
ssb	CTTATTCAGAACGATTTTTTTCAGGAGACACGAAC
gshB	TACGATTTGGCGATTTGGGCTAACGGAGAAGAATA
ahpF	CTTGCATGATGATGTTTAAAGCCCAGGAGATAAAC
moaB	ACATTGGCGGCTAAAACGTCAAAAGGAGAGATCAG
orn	ATCAATATAGTCACTGTGAATGGGTGGAAAATAGC
gmhA	TTTTGTCTATTACATTTATGCTGAAGGATATCCTC
galU	CACGTTCAAAACACGAACAGTCCAGGAGAATTTAA
asnA	TTAATCATAAGCAACAGGACGCAGGAGTATAAAAA
glpK	AGCTTCGCTGTAATATGACTACGGGACAATTAAAC
tolB	TATCGTGGGCCATCGGTCCAGATAAGGGAGATATG
thrC	TGGATACGGCGGGCGCACGAGTACTGGAAAACTAA
yaiE	GAAGTAGATGTTCAACTACCAAACAGGGCCAGTTT
ybdZ	CTCTGGCAACCACTTTTCCATGACAGGAGTTGAAT
ychN	ATGAGTGTCTAATTCCCTGAATACAGGAGTAAATA
osmC	TATAATTTCCTTTTTAAGCCCACAGGAGAGCAACA
yoaB	CAGCACGAAAATGGAAGTATAATGAGGACAAAATG
yfbU	TTTTTCACCGTAGTAGAGTGATACAGGAGTCAACA
ygiN	GTTAACTAGAGCTCAGGCTTTAGAAGGAGTTAACC
malE	TTTCACGAGCACTTCACCAACAAGGACCATAGATT
pyrH	TTCATTTCAATCGTTGACAGTCTCAGGAAAGAAAC
pspA	ACAATCCTGAACGCAGAAATCAAGAGGACAACATT
ydfG	GTTATTGACACACAAAAGCGTTGAGGAACAGTGAG
ydjA	TTTTGTGAATAAATATCACGACAGGAGTTAATCAA
ibpB	AGGTACTTACTCGCTTCTTAGAAGGAGAAATGACT
panC	GGCGAAGAACACAGTTTCCATTAAGGAGTCACGTT